POOBOBOOBBOBO
OSOSOSBSBSOSO
OOBBOBBOBOOOO
BSOSBSBSOSOSB
OBOBOOOOOBOBO
BSOSOSOSOSOSO
BOOOBOOBOEOOO
OSOSOSBSBSOSO
BOOOOOOOBOEOO
OSOSBSOSBSOSO
OOOOOBOOOOOBO